+---+---+---+---+---+---+---+---+---+
|       |               |           |
+   +---+   +---+---+   +   +---+   +
|       |       |           | G |   |
+   +   +   +---+   +---+---+   +---+
|   |           |       |           |
+   +---+---+---+   +---+---+   +---+
|   |           |       |           |
+   +   +---+   +---+   +---+   +---+
|       |       |       |           |
+---+---+   +---+   +---+---+   +---+
|       |   |           |           |
+   +   +   +---+   +---+---+   +---+
|   |   |   |   |       |           |
+   +   +   +   +---+   +---+   +---+
|   |   |   |           |           |
+   +   +   +   +---+---+---+   +---+
| S |       |                       |
+---+---+---+---+---+---+---+---+---+
