+---+---+---+---+---+---+---+---+---+---+---+---+---+---+---+---+---+---+---+---+---+---+---+---+---+---+---+---+---+---+---+---+
|       |       |       |       |       |       |       |       |       |       |       |       |       |       |       |       |
+   +   +   +   +   +   +   +   +   +   +   +   +   +   +   +   +   +   +   +   +   +   +   +   +   +   +   +   +   +   +   +   +
|   |       |       |       |       |       |       |       |       |       |       |       |       |       |       |       |   |
+   +   +   +   +   +   +   +   +   +   +   +   +   +   +   +   +   +   +   +   +   +   +   +   +   +   +   +   +   +   +   +   +
|       |       |       |       |       |       |       |       |       |       |       |       |       |       |       |       |
+   +   +   +   +   +   +   +   +   +   +   +   +   +   +   +   +   +   +   +   +   +   +   +   +   +   +   +   +   +   +   +   +
|   |       |       |       |       |       |       |       |       |       |       |       |       |       |       |       |   |
+   +   +   +   +   +   +   +   +   +   +   +   +   +   +   +   +   +   +   +   +   +   +   +   +   +   +   +   +   +   +   +   +
|       |       |       |       |       |       |       |       |       |       |       |       |       |       |       |       |
+   +   +   +   +   +   +   +   +   +   +   +   +   +   +   +   +   +   +   +   +   +   +   +   +   +   +   +   +   +   +   +   +
|   |       |       |       |       |       |       |       |       |       |       |       |       |       |       |       |   |
+   +   +   +   +   +   +   +   +   +   +   +   +   +   +   +   +   +   +   +   +   +   +   +   +   +   +   +   +   +   +   +   +
|       |       |       |       |       |       |       |       |       |       |       |       |       |       |       |       |
+   +   +   +   +   +   +   +   +   +   +   +   +   +   +   +   +   +   +   +   +   +   +   +   +   +   +   +   +   +   +   +   +
|   |       |       |       |       |       |       |       |       |       |       |       |       |       |       |       |   |
+   +   +   +   +   +   +   +   +   +   +   +   +   +   +   +   +   +   +   +   +   +   +   +   +   +   +   +   +   +   +   +   +
|       |       |       |       |       |       |       |       |       |       |       |       |       |       |       |       |
+   +   +   +   +   +   +   +   +   +   +   +   +   +   +   +   +   +   +   +   +   +   +   +   +   +   +   +   +   +   +   +   +
|   |       |       |       |       |       |       |       |       |       |       |       |       |       |       |       |   |
+   +   +   +   +   +   +   +   +   +   +   +   +   +   +   +   +   +   +   +   +   +   +   +   +   +   +   +   +   +   +   +   +
|       |       |       |       |       |       |       |       |       |       |       |       |       |       |       |       |
+   +   +   +   +   +   +   +   +   +   +   +   +   +   +   +   +   +   +   +   +   +   +   +   +   +   +   +   +   +   +   +   +
|   |       |       |       |       |       |       |       |       |       |       |       |       |       |       |       |   |
+   +   +   +   +   +   +   +   +   +   +   +   +   +   +   +   +   +   +   +   +   +   +   +   +   +   +   +   +   +   +   +   +
|       |       |       |       |       |       |       |       |       |       |       |       |       |       |       |       |
+   +   +   +   +   +   +   +   +   +   +   +   +   +   +   +   +   +   +   +   +   +   +   +   +   +   +   +   +   +   +   +   +
|   |       |       |       |       |       |       |       |       |       |       |       |       |       |       |       |   |
+   +   +   +   +   +   +   +   +   +   +   +   +   +   +   +   +   +   +   +   +   +   +   +   +   +   +   +   +   +   +   +   +
|       |       |       |       |       |       |       |       |       |       |       |       |       |       |       |       |
+   +   +   +   +   +   +   +   +   +   +   +   +   +   +   +   +   +   +   +   +   +   +   +   +   +   +   +   +   +   +   +   +
|   |       |       |       |       |       |       |       |       |       |       |       |       |       |       |       | G |
+   +   +   +   +   +   +   +   +   +   +   +   +   +   +   +   +   +   +   +   +   +   +   +   +   +   +   +   +   +   +   +   +
|       |       |       |       |       |       |       |       |       |       |       |       |       |       |       |       |
+   +   +   +   +   +   +   +   +   +   +   +   +   +   +   +   +   +   +   +   +   +   +   +   +   +   +   +   +   +   +   +   +
|   |       |       |       |       |       |       |       |       |       |       |       |       |       |       |       |   |
+   +   +   +   +   +   +   +   +   +   +   +   +   +   +   +   +   +   +   +   +   +   +   +   +   +   +   +   +   +   +   +   +
|       |       |       |       |       |       |       |       |       |       |       |       |       |       |       |       |
+   +   +   +   +   +   +   +   +   +   +   +   +   +   +   +   +   +   +   +   +   +   +   +   +   +   +   +   +   +   +   +   +
|   |       |       |       |       |       |       |       |       |       |       |       |       |       |       |       |   |
+   +   +   +   +   +   +   +   +   +   +   +   +   +   +   +   +   +   +   +   +   +   +   +   +   +   +   +   +   +   +   +   +
|       |       |       |       |       |       |       |       |       |       |       |       |       |       |       |       |
+   +   +   +   +   +   +   +   +   +   +   +   +   +   +   +   +   +   +   +   +   +   +   +   +   +   +   +   +   +   +   +   +
|   |       |       |       |       |       |       |       |       |       |       |       |       |       |       |       |   |
+   +   +   +   +   +   +   +   +   +   +   +   +   +   +   +   +   +   +   +   +   +   +   +   +   +   +   +   +   +   +   +   +
|       |       |       |       |       |       |       |       |       |       |       |       |       |       |       |       |
+   +   +   +   +   +   +   +   +   +   +   +   +   +   +   +   +   +   +   +   +   +   +   +   +   +   +   +   +   +   +   +   +
|   |       |       |       |       |       |       |       |       |       |       |       |       |       |       |       |   |
+   +   +   +   +   +   +   +   +   +   +   +   +   +   +   +   +   +   +   +   +   +   +   +   +   +   +   +   +   +   +   +   +
|       |       |       |       |       |       |       |       |       |       |       |       |       |       |       |       |
+   +   +   +   +   +   +   +   +   +   +   +   +   +   +   +   +   +   +   +   +   +   +   +   +   +   +   +   +   +   +   +   +
|   |       |       |       |       |       |       |       |       |       |       |       |       |       |       |       |   |
+   +   +   +   +   +   +   +   +   +   +   +   +   +   +   +   +   +   +   +   +   +   +   +   +   +   +   +   +   +   +   +   +
|       |       |       |       |       |       |       |       |       |       |       |       |       |       |       |       |
+   +   +   +   +   +   +   +   +   +   +   +   +   +   +   +   +   +   +   +   +   +   +   +   +   +   +   +   +   +   +   +   +
|   |       |       |       |       |       |       |       |       |       |       |       |       |       |       |       |   |
+   +   +   +   +   +   +   +   +   +   +   +   +   +   +   +   +   +   +   +   +   +   +   +   +   +   +   +   +   +   +   +   +
|       |       |       |       |       |       |       |       |       |       |       |       |       |       |       |       |
+   +   +   +   +   +   +   +   +   +   +   +   +   +   +   +   +   +   +   +   +   +   +   +   +   +   +   +   +   +   +   +   +
|   |       |       |       |       |       |       |       |       |       |       |       |       |       |       |       |   |
+   +   +   +   +   +   +   +   +   +   +   +   +   +   +   +   +   +   +   +   +   +   +   +   +   +   +   +   +   +   +   +   +
|       |       |       |       |       |       |       |       |       |       |       |       |       |       |       |       |
+   +   +   +   +   +   +   +   +   +   +   +   +   +   +   +   +   +   +   +   +   +   +   +   +   +   +   +   +   +   +   +   +
| S |       |       |       |       |       |       |       |       |       |       |       |       |       |       |       |   |
+---+---+---+---+---+---+---+---+---+---+---+---+---+---+---+---+---+---+---+---+---+---+---+---+---+---+---+---+---+---+---+---+
