+---+---+---+---+---+---+---+---+---+---+---+---+---+---+---+---+---+---+---+---+---+---+---+---+---+---+---+---+---+---+---+---+
|                                                                                                                               |
+   +   +---+   +---+   +---+---+   +   +---+---+---+---+---+---+---+---+---+---+---+---+---+---+---+   +---+---+---+---+---+   +
|   |   |   |   |   |   |   |       |   |   |               |               |           |   |           |                   |   |
+   +   +   +   +   +---+   +   +---+   +   +   +   +---+---+   +---+---+   +---+---+   +   +   +---+---+   +---+---+---+---+   +
|   |   |   |   |   |       |   |   |   |   |       |           |   |   |           |       |   |                   |       |   |
+   +   +   +   +---+   +---+   +---+   +   +   +---+   +---+---+   +   +---+---+   +---+---+   +   +---+   +---+---+   +---+   +
|   |   |   |   |       |   |           |   |   |       |                       |               |           |               |   |
+   +   +   +---+   +---+   +---+---+   +   +---+   +---+   +---+---+---+---+   +---+   +---+---+   +---+---+   +---+---+   +   +
|   |   |           |       |       |   |   |       |                               |       |       |           |           |   |
+   +   +   +   +---+   +---+   +   +   +---+   +---+---+   +---+---+---+   +---+---+---+   +---+---+   +---+---+   +---+---+   +
|   |   |       |   |   |   |       |   |       |           |           |               |               |           |       |   |
+   +   +   +---+   +   +   +   +   +   +   +---+---+---+   +   +---+   +   +---+---+   +---+---+---+---+   +---+---+   +---+   +
|   |   |   |       |   |   |       |   |   |           |   |   |   |   |                   |   |           |           |   |   |
+   +   +   +   +---+   +   +   +   +---+   +---+---+---+   +   +---+   +   +---+---+---+   +   +   +---+---+   +---+---+---+   +
|       |   |   |       |   |       |       |               |           |                   |       |           |               |
+   +   +   +   +   +   +   +---+   +   +---+   +---+---+   +---+---+---+   +---+   +---+---+---+   +   +---+---+   +---+   +---+
|   |   |   |   |       |   |   |   |   |                                   |   |           |   |   |   |           |   |   |   |
+   +   +   +   +---+   +---+   +   +   +   +---+---+---+---+---+---+   +---+   +---+---+   +   +   +---+   +---+---+   +   +   +
|   |   |   |       |       |   |   |   |                                   |   |           |   |   |       |           |   |   |
+   +   +   +---+   +   +---+   +   +   +---+   +---+---+   +---+---+---+   +---+   +---+---+---+   +   +---+   +---+   +   +---+
|   |   |       |   |       |   |   |       |               |           |                   |       |           |   |   |       |
+   +   +   +   +   +   +---+   +   +   +   +---+---+---+   +   +---+   +   +---+---+---+   +   +---+---+---+---+---+   +---+   +
|   |   |       |   |       |   |   |   |   |           |   |   |   |   |                   |   |           |   |       |   |   |
+   +   +   +   +   +---+   +   +   +   +   +---+---+---+   +   +---+   +   +---+---+   +---+   +   +---+   +---+   +---+   +---+
|   |   |       |       |       |   |   |       |           |           |               |           |               |   |   |   |
+   +   +   +   +   +---+---+---+---+   +   +   +---+---+   +---+---+---+   +---+---+---+   +---+---+---+---+---+---+---+   +   +
|   |   |       |       |                   |       |                               |       |       |                       |   |
+   +   +   +   +   +   +   +---+---+---+   +---+   +---+   +---+---+---+---+   +---+   +---+   +---+   +---+   +---+---+---+   +
|   |   |       |   |   |   |           |   |   |       |                       |       |       |       |   |   |   |           |
+   +   +   +   +   +   +   +   +   +   +   +---+---+   +---+---+---+---+---+---+   +---+---+---+   +---+   +---+   +---+   +---+
|       |       |       |   |           |               |   |           |                           |           |   |           |
+   +   +   +---+   +---+   +   +   +   +   +---+---+---+   +---+---+   +   +---+---+---+---+---+   +---+   +   +   +---+   +---+
|   |   |   |       |       |           |       |       |     G     |       |                   |       |   |   |   |           |
+   +   +---+   +---+   +   +---+   +   +   +   +   +   +   +---+---+   +---+   +   +   +   +   +---+   +   +   +   +---+   +---+
|   |   |       |               |       |   |   |   |   |               |                           |   |   |                   |
+   +   +   +---+   +---+---+   +---+---+   +   +   +   +   +   +---+   +   +   +   +   +   +   +---+   +   +   +   +---+   +---+
|   |   |   |       |   |   |               |       |       |           |                       |       |   |   |   |           |
+   +   +   +   +---+   +   +   +---+---+   +---+---+---+---+---+---+---+---+---+---+---+---+---+   +---+   +   +   +---+   +---+
|   |   |   |       |   |   |   |   |   |   |                                       |               |           |   |           |
+   +   +   +---+   +   +   +   +   +   +   +---+---+---+---+---+---+---+---+---+---+---+   +---+   +---+   +---+   +---+   +---+
|   |   |       |   |   |   |   |   |   |                   |       |                       |   |       |   |   |   |           |
+   +   +---+   +   +---+   +   +---+---+   +---+---+---+   +---+---+   +---+---+---+---+---+   +---+   +---+   +---+---+   +---+
|   |   |   |   |       |   |                           |       |       |           |       |   |                       |       |
+   +   +   +   +---+   +   +---+---+---+---+---+---+   +---+   +   +---+   +---+   +   +   +---+   +---+---+---+---+---+---+---+
|   |   |   |       |   |       |       |           |       |       |       |       |   |   |   |   |                       |   |
+   +   +   +   +   +   +---+   +   +---+---+---+   +---+   +---+---+   +---+   +---+   +   +   +   +   +---+---+---+---+---+   +
|       |   |   |   |       |   |   |           |       |       |       |       |       |   |   |   |   |                       |
+   +   +   +   +   +---+   +   +---+   +---+   +---+   +---+   +   +---+   +---+   +---+   +---+   +   +   +---+---+---+---+   +
|   |   |   |           |   |           |   |       |       |       |       |       |       |   |   |   |   |               |   |
+   +   +   +---+---+   +   +---+   +---+---+---+   +---+   +---+---+   +---+   +---+---+   +   +   +   +   +   +   +---+   +   +
|   |   |           |   |           |   |       |       |       |       |       |       |   |   |   |   |   |       |   |   |   |
+   +   +   +   +   +   +---+   +---+---+   +   +---+   +---+---+   +---+   +---+   +   +   +---+   +   +   +---+---+   +   +   +
|   |   |           |       |   |   |       |       |       |       |       |   |       |   |   |   |   |               |   |   |
+   +   +   +   +   +---+   +---+   +---+   +---+   +---+   +   +---+   +---+   +   +   +   +   +   +   +   +---+---+   +   +   +
|   |   |           |   |       |   |   |       |       |   |   |       |       |       |   |   |   |   |   |       |   |   |   |
+   +   +---+   +   +   +   +   +   +---+---+   +---+   +---+   +   +---+   +---+   +   +   +---+   +   +---+   +   +   +   +   +
|           |       |   |   |   |       |   |       |       |       |       |   |       |   |   |   |               |   |   |   |
+   +---+   +---+---+   +---+---+---+   +---+---+   +---+   +---+---+   +---+   +---+---+   +   +   +---+---+---+---+   +   +   +
|   |   |   |                               |   |       |               |       |           |   |                       |   |   |
+   +   +   +   +---+---+---+---+   +---+   +---+---+---+---+---+---+---+---+---+   +---+   +---+   +---+---+---+---+---+   +   +
|   |   |   |   |               |       |                                           |   |   |   |   |                       |   |
+   +   +   +   +---+---+---+---+---+   +---+   +---+---+---+---+   +---+---+---+---+---+   +---+---+---+---+---+---+---+---+   +
| S |   |                                   |                                                                                   |
+---+---+---+---+---+---+---+---+---+---+---+---+---+---+---+---+---+---+---+---+---+---+---+---+---+---+---+---+---+---+---+---+
