+---+---+---+---+---+---+---+---+---+---+---+---+---+---+---+---+---+---+---+---+---+---+---+---+---+---+---+---+---+---+---+---+
|                                                                                                                               |
+   +   +   +   +   +   +   +   +   +   +   +   +   +   +   +   +   +   +   +   +   +   +   +   +   +   +   +   +   +   +   +   +
|                                                                                                                               |
+   +   +   +   +   +   +   +   +   +   +   +   +   +   +   +   +   +   +   +   +   +   +   +   +   +   +   +   +   +   +   +   +
|                                                                                                                               |
+   +   +   +   +   +   +   +   +   +   +   +   +   +   +   +   +   +   +   +   +   +   +   +   +   +   +   +   +   +   +   +   +
|                                                                                                                               |
+---+---+---+---+---+---+---+---+---+---+---+---+---+---+---+---+---+---+---+---+---+---+---+---+---+---+---+---+---+---+---+---+
|       |                                           |                   |                               |                       |
+   +   +   +---+   +---+   +   +---+---+---+---+   +---+---+---+---+---+   +   +---+---+---+---+---+   +   +---+---+---+---+   +
|   |   |   |   |   |       |   |               |                           |       |               |       |               |   |
+   +   +   +   +   +   +---+   +---+---+---+---+   +---+   +---+---+---+---+---+   +---+---+---+---+   +---+   +---+---+---+   +
|   |       |   |       |   |       |               |   |   |   |               |                       |       |           |   |
+   +   +   +---+   +---+   +---+   +   +---+---+   +---+   +---+   +---+---+   +---+---+---+---+---+---+   +---+   +---+   +   +
|   |   |   |       |   |   |   |   |   |       |           |       |       |       |                   |   |       |   |       |
+   +   +   +   +---+   +   +   +   +   +---+---+   +---+---+   +   +---+   +   +---+   +---+---+---+   +   +   +---+   +---+   +
|       |   |   |       |   |   |   |               |   |       |   |   |   |       |                   |   |   |           |   |
+   +   +   +   +   +---+   +   +   +   +---+---+   +---+   +---+   +---+---+   +---+---+   +   +---+   +   +   +---+---+   +   +
|   |   |   |   |   |       |   |               |   |                           |   |   |   |   |   |   |   |           |   |   |
+   +   +   +   +   +   +---+   +   +---+---+   +   +   +---+---+   +---+   +---+---+---+   +   +   +   +   +---+---+   +   +   +
|   |   |   |   |   |       |   |   |       |       |   |   |   |   |   |   |   |   |   |   |   |   |   |           |   |   |   |
+   +   +   +   +   +---+   +   +   +   +   +---+   +   +   +---+   +---+   +---+---+---+---+   +---+   +---+   +---+   +   +   +
|   |       |   |       |   |   |   |           |   |   |       |           |   |   |                       |   |       |   |   |
+   +   +   +   +---+   +   +---+   +   +   +   +---+   +---+---+   +---+---+---+---+   +---+   +---+   +   +---+   +---+   +   +
|       |   |       |   |       |   |           |   |               |   |   |   |       |   |   |   |   |           |       |   |
+   +   +   +   +   +   +   +---+   +   +   +   +   +---+   +   +---+---+---+---+   +---+---+   +   +   +---+---+---+   +---+   +
|   |   |   |   |   |   |   |   |   |           |       |   |   |   |   |   |       |           |   |   |               |       |
+   +   +   +   +   +   +---+   +   +   +   +   +   +   +---+---+---+---+---+   +---+   +---+   +   +   +---+---+---+---+   +---+
|   |   |   |   |   |       |       |           |   |           |   |   |       |               |   |                           |
+   +   +   +   +   +   +   +   +   +   +   +---+   +   +---+   +---+---+   +---+   +---+---+---+   +   +---+---+---+---+---+   +
|   |   |   |   |   |   |   |   |   |       |           |   |           |   |   |   |           |   |   |       |           |   |
+   +   +   +   +   +   +   +   +   +---+---+   +---+   +---+   +---+---+   +---+   +   +   +   +---+   +   +---+   +---+   +   +
|       |   |   |   |   |   |   |                   |   |   |                       |           | G |   |   |       |   |   |   |
+   +   +   +   +   +   +   +   +---+---+---+---+   +   +---+---+---+---+---+---+---+---+---+---+   +   +---+   +---+   +---+   +
|   |   |   |       |       |   |               |   |   |   |   |               |                               |               |
+   +   +   +   +---+   +---+   +---+---+---+---+---+---+---+   +   +   +   +   +   +---+---+---+---+---+---+---+   +   +---+---+
|   |           |       |       |                               |               |   |                   |       |   |       |   |
+   +   +   +---+   +---+   +   +   +---+---+---+   +---+---+   +---+   +   +   +   +   +---+---+---+   +   +   +   +---+   +---+
|   |   |   |       |       |       |           |   |       |       |           |   |   |           |   |   |   |   |   |   |   |
+   +   +   +   +---+   +---+   +---+   +   +   +   +   +   +---+   +---+---+---+   +   +   +   +   +   +   +   +   +   +   +---+
|       |   |   |       |   |   |               |   |   |   |   |                   |   |           |   |       |   |   |   |   |
+   +   +   +   +   +---+   +   +   +   +   +   +   +   +   +   +---+   +---+---+   +   +   +   +   +   +---+---+   +   +   +---+
|   |   |   |   |       |   |   |               |   |       |       |   |       |   |   |           |               |   |   |   |
+   +   +   +   +---+   +   +   +   +   +   +   +   +   +   +   +   +---+   +---+   +   +   +   +   +   +---+   +   +   +   +   +
|   |   |   |       |   |   |   |               |   |   |   |   |   |           |   |   |           |           |   |   |   |   |
+   +   +   +---+   +   +---+   +   +   +   +   +   +   +---+   +   +---+---+---+   +   +---+   +   +   +---+---+   +   +   +---+
|   |       |   |   |       |   |               |   |   |   |   |   |       |       |       |       |   |       |   |   |   |   |
+   +   +   +   +   +---+   +   +---+   +   +---+   +   +   +---+   +---+---+---+   +   +   +---+---+   +   +   +   +   +   +---+
|       |   |   |       |   |       |       |       |   |       |               |       |           |   |   |   |   |   |   |   |
+   +   +   +   +   +   +   +---+   +---+---+   +---+   +---+---+---+   +---+---+---+   +---+---+---+   +   +   +   +---+   +---+
|   |   |   |   |   |   |       |               |   |       |   |   |               |   |               |       |   |       |   |
+   +   +   +   +   +   +---+   +   +---+   +---+---+   +   +---+   +---+---+---+---+---+---+---+   +---+---+---+   +   +---+---+
|   |   |   |   |           |   |   |   |   |   |       |       |       |               |       |   |           |               |
+   +   +   +   +---+---+   +   +   +   +   +---+   +---+---+   +---+---+---+   +---+   +   +---+   +   +   +   +---+   +---+   +
|   |   |               |   |   |   |   |           |       |                           |   |       |   |   |       |   |       |
+   +   +   +---+---+   +   +   +   +---+   +---+---+   +   +---+---+   +---+   +---+---+---+---+   +   +   +   +   +---+   +   +
|           |   |   |   |   |               |           |           |           |       |       |       |   |   |           |   |
+   +---+   +   +---+   +   +   +---+---+---+   +---+---+---+---+   +---+---+   +   +---+   +---+---+   +   +   +   +---+---+   +
|   |   |   |       |   |   |   |               |               |           |   |   |   |           |   |       |   |       |   |
+   +   +   +---+---+   +---+   +---+---+---+---+   +---+---+   +---+---+   +   +---+   +---+   +---+---+---+---+   +---+---+   +
|   |   |                                           |       |           |   |   |   |       |       |                       |   |
+   +   +---+---+   +---+---+---+---+---+   +---+---+---+---+---+---+   +---+   +---+---+   +---+---+   +---+---+---+---+   +   +
| S |           |   |                   |   |                       |                                   |               |       |
+---+---+---+---+---+---+---+---+---+---+---+---+---+---+---+---+---+---+---+---+---+---+---+---+---+---+---+---+---+---+---+---+
